R 2000 1000
NO ./path_to_the_north_texture
SO ./path_to_the_south_texture
WE ./path_to_the_west_texture
EA ./path_to_the_east_texture

S ./path_to_the_sprite_texture
F 220,100,0
C 225,30,0

11111111111111111111111111111111111111
11111111111100000000000000001111111111
10110000011100000010000010001111111111
1001000000000000000000001000111110000111
10010000011100000000000010001111111000111
1000000000110000011101111000111111111111111
1001000011111101110000001000111100001
10010000111101110101001000101111111111
10010000101010111000000100011111
10010000000000001100000010001111111111
10010000000000001101010010001111111111
10010000110101011111011110101111111111
10010000111101011111011110001111111111
11111111111111111111111111111111111111