R 1000 500
NO ./d898a9f976a79f74fa8c89a56d0288de.xpm
SO ./grunge-brick-wall-texture.xpm
WE ./brick-texture_1449834.xpm
EA ./unnamed.xpm

S ./path_to_the_sprite_texture
F 220,100,0
C 225,30,0

                   111
                   101
                111101111
                100000001
               11000100011
              1110010100111
              1000000000001
     111111111100001000000111111111111111111111111111111111111111111111111111
     1000000000000000000000000000000000000000000000000000000000000000000000011
     1011111111111001010011111111111111111111111011111111111110111111111111011
     101       11000100011                     101           101          101
     101        100000001                      101           101          101
     101        111101111111111111111111111111110111         101          101
     101           100000000000000000000000W00000001      11110111        101
     10111111111111111111111100111111111011011111101      10000001        101
     1000000000000000000000000011      100001  111011111111011110111111111101
     11111111111111111110111111111111111111111110000000000001  10000000000001
                       10000000000000000000000000111111111111  11111111111111
                       111111111111111111111111111