111111111111111111111111111111
110001000000000000000000000001
100100001101000000000000000001
100111101001101000000000000001
100000101101000000000111110011
101110100001000000000000000001
101010111111000000000001111101
101010001000000000000000000001
100000100001000000000000000001
100100000000001000000000000001
100111110001000000000001111101
100000001010000000000000000001
111111001010001000000000000001
100000001000000000000000000001
100000000000000000000000000001
100000000000000000000000000001
100000000000000000000000000001
111111111111111111111111111111