R 1500 1000
NO ./imyy.xpm
SO ./grunge-brick-wall-texture.xpm
WE ./brick-texture_1449834.xpm
EA ./unnamed.xpm

S ./sprite.xpm
F 220,100,0
C 225,30,0

                   111
                   101
                111121111
                100020001
               11000200011
              111000N000111
              1000000000001
     1111111111000000000000111111111111111111111111111111111111111111111111111
     1000000000000000000000000000000000000000000000000000000000000000000000011
     1011111111111000010011111111111111111111111011111111111110111111111111011
     101       11000100011                     101           101          101
     101        100000001                      101           101          101
     101        111101111111111111111111111111110111         101          101
     101           100000000000000000000000000000011      11110111        101
     10111111111111111111111100111111111011011111101      10000001        101
     1000000000000000000000000011      100001  111011111111011110111111111101
     11111111111111111110111111111111111111111110000000000001  10000000000001
                       10000000000000000000000000111111111111  11111111111111
                       111111111111111111111111111