R 2000 1000
NO ./path_to_the_north_texture
SO ./path_to_the_south_texture
WE ./path_to_the_west_texture
EA ./path_to_the_east_texture

S ./path_to_the_sprite_texture
F 220,100,0
C 225,30,0

 11111111111111111111111111
11000001
1000000111111111111111111
1011000001110000002000001
1001000000000000000000001
111111111011000001110000111111111
100000000011000001110111111111111
111101111111100001000000100000001
111101111111100001010100100011111        1111111
11000000110110000100000010001         111101
10002000000010011100000010001         101111
100000000000001 1110101001001111111111101
11000001110101011111011110N00000000000001
11110111 11101101 10111101000111111111111
1 111    11111 1111111 111111111111